012004110899000009912346AG-MEDAVI
7300099123460000000008765430000000000000000099556677881600000043220041108041116
73000991234600000000022210000000000000000000995566778816000000410
7300099123460000000003331006000000000000000099569041666300000043220041108041116
7300099123460000000004441002000000000000000099557012755400000043220041108041116
7300099123460000000007771017000000000000000099809011112400000043220041108041116
7300099123460000000005551007000000000000000099616161191500000043220041108041116
092004110899000000006
