012004110899000009912346AG-MEDAVI
7300099123460000000008765432000000000000000099556677881100000043220041108041116
73000991234600000000022210010000000000000000995566778812000000410              
7300099123460000000003331002000000000000000099569041666600000043220041108041116
7300099123460000000004441003000000000000000099557012755500000043220041108041116
7300099123460000000007771014000000000000000099809011112200000043220041108041116
7300099123460000000005551004000000000000000099616161191100000043220041108041116
092004110899000000006                                                         